NO ./path_to_the_north_texture
SO ./path_to_the_south_texture
WE ./path_to_the_west_texture
EA ./path_to_the_west_texture
F 	0,0,1
C 0,0,0


11111
10N01
100001
111111