NO     ./textures/eagle.xpm
SO   ./textures/redbrick.xpm
WE   ./textures/purplestone.xpm
EA     ./textures/greystone.xpm
F   255,255,255
C   255,255,255

XXXXXXXXXXXXXXXXXXXXXXX
X111111111111XXXXXXXXXX
X100N00000001XXXXXXXXXX
X111111111111111111111X
X1000001 111XXXXXXXXXXX
X1111111 111XXXXXXXXXXX
XXXXXXXXXXXXXXXXXXXXXXX