NO ./img/bojii.xpm
SO ./img/naru.xpm
WE ./img/visage.xpm
EA ./img/visagee.xpm

F 0,0,255
C 0,255,0

11111
100011
1S0001
111111
